1111111
1115111
1200011
1110111
1160041
1101111
1131111
1111111
#
11111111
11141111
12000011
11110111
11140051
11111611
11111311
11111111