1111111
1121111
1300041
1111011
1111111
#
1111111
1141111
1424111
1000101
1030001
1000111
1111111