111111111
111110111
111140131
120000101
111010001
111111111
#
1111111
1111311
1111011
1110011
1111011
1200041
1111111